1111111111111
10010000000C1
1C00011111001
1P000000C1001
11111111111111