1111111111111
1001000E000C1
1C00011111001
1P0000C0C1001
1111111111111