11111111111111111111111111
1000C010000000110000000001
100000100111101100110000C1
10010010011C10110011000001
10010010011010110011011111
1P0100000110000000110000E1
11111111111111111111111111