1111111111111
10010C00E0001
10000111110011111
1P000000010000001
11111111111111111